1111111111111
1P00000000001
1111100000001
1100000001101
1111111100011
1000000001111
1011111111111
1011111111111
1001111111111
1000000111111
1000000000001
1000000000001
10000000000E1
1000000000001
1C00111111111
