1111111
1000101
1000P01
1E00001
1C00001
1111111