111111111111
10001010E001
100000101111
1000C0000001
1000001110P1
111111111111
