111111111111
1C00101000E1
100000101111
100000000001
1000001110P1
111111111111
