111111111111
1E0010101C01
100000100001
100000001001
1C00001110P1
111111111111
