111111111
100010101
1000P0101
1E0000001
1C0000111
111111111
